███████  ███  █    ██ ███████
█S    █ █   █ ███           █
█ ███ █  ███   ██  █  █ ███ █
█ ███ █ █ ████ █ █ ██ █ ███ █
█ ███ █  █████  █  ██ █ ███ █
█     █ █ █  ███ ██ █ █     █
█ █████ █ █ █ █ █ █ █ ███████
         █    █ █ █          
 ████ ███ █ █ █  █   █ █ █ █ 
  █ █    █ █  █ █  ██ ███   █
█  █████     ███       █     
  █ █  █ ██   █ █  ██   █  █ 
█    ███ █ ██ █  █ █   █ ██  
 █ ███     █       █  ███ █ █
 ███  █ █ █  █ ███  ██ ██ █  
 █  █  █    █ █     ██ ██  █ 
  █ █ ██ █  █ ████   █    █  
█████  ██  █    █  ████████ █
█ █ ███  █   ████     ██ ██  
█ ██     █ █   ██  █   ██  █ 
█ ██  █  █  ██ █ █ ██████ ███
        ███  █  █ ███   █████
███████ █   ████ ████ █ ███  
█     █   █   ███ ███   ██   
█ ███ █ █   █ ████  █████ █  
█ ███ █ ██ █    █  █        █
█ ███ █ █    ██████  █████ █ 
█       █  █  ██    █ █  █ █ 
███████ █ ███    █ █   █  █ E
